111111111111111111111111111111111111111111111111111
1CCCC1WWW000C1WWCC1W00CCC1W000000111111000010010101
11WWCC10W0CCC1W0000001C00C00WW0W1WWCC10W0CCC1W00001
11WWCC10W0CCC1W00000011111111111WWCC10W0CCC1W011001
11WWCC001W0CC10W0CCC1WW0CCC1W00000000011WWCC1WC1001
10000E000CC10CCC0C1WWCC10W0CCC1W0011101000000WC0001
11WWCC1W10WCC10W0CCC00100CC1W0000C10101000WC0C00001
1000P1WWCC1W000000C00C00C1W0CC1W1111W0CC10C11WW00C1
11WWCC1W1W0CC1W000W110C1W0CC1C0011WWCC1W0001WCWWWW1
10000W1WWCC1W00000CW11WWCC10W0CCC1W00W000000CC10001
111111111111111111111111111111111111111111111111111